711111E11111111111E11111A
2     2           2     2
2     2  z     g  2     2
2  a  2  U     V  2  d  2
2     6           6     2
2                       2
2     5           5     2
B11111Db    x    aB11111D
2     2           2     2
2     2e    X    c2     2
2  b  6           6  e  2
2                       2
2     5           5     2
B11111D  d     f  B11111D
2     6           6     2
2                       2
2  c  74 3A 311111A  b  2
2     2   2      h2     2
2     2iii2      j2     2
811111C111C1111111C111119